PPPPPPPPPPPPPPPPPPPPPPPPPPPPPPPPPPPPPPPP
P--------------------------------------P
P----S---------------------------------P
P--------------------------------------P
P--------------------------------------P
P--------------------------------------P
P--------------------------------------P
P--------------------------------------P
P--------------------------------------P
P--------------------------------------P
P--------------------------------------P
P--------------------------------------P
P--------------------------------------P
P--------------------------------------P
P--------------------------------------P
P--------------------------------------P
P--------------------------------------P
P--------------------------------------P
P--------------------------------------P
P--------------------------------------P
P--------------------------------------P
P--------------------------------------P
P--------------------------------------P
P--------------------------------------P
P--------------------------------------P
P--------------------------------------P
P--------------------------------------P
P--------------------------------------P
P--------------------------------------P
P--------------------------------------P
P--------------------------------------P
P--------------------------------------P
P--------------------------------------P
P--------------------------------------P
P--------------------------------------P
P--------------------------------------P
P------------------PP------------------P
P------------------PP------------------P
P------------------PP------------------P
PPPPPPPPPPPPPPPPPPPPPPPPPPPPPPPPPPPPPPPP